! map 1

#################
#               #
#               #
#               #
#               #
#######  ########


! map 2

#######  ########
#               #
#               #
#               #
#               #
#################

map 1 : 7 5 <-> map 2 : 7 0
